##############################################################
#............................................................#
#.....M......................................................#
#............................................................#
#....######......####........................................#
#.................#..........................................#
#.................#..........................................#
#...##......#....#....####...................................#
#...##.......#...............................................#
#............####............................................#
#........##..####..##........................................#
#........##..####..##........................................#
#........##........##........................................#
#............................................................#
#............................................................#
#...........#...#............................................#
#...........#...#............................................#
#.......#...#...#............................................#
#.......#....................................................#
#.......#.....#########......................................#
#.....................#......................................#
#......######.........#......................................#
#.....................#......................................#
#............................................................#
##############################################################