############################################################################################################################################
#####...................#######.#.#.#######################................................................................................#
#..........................................................................................................................................#
#..........................................................##############....................................####################.##########
#.###......#####.....................#.....................................................................................................#
#.....................................#.....................................................................#########.##########.#########.#
#..................#####............#.#.......................###............................###############...............................#
#...................................#.........................................................................##############################
#........###############...................................................................................................................#
#..........................................................................................................................................#
#..............................................#############################################################################################
#..................................................############.................######..........................###############..###########
#............########################..........###.####################.#########.####.########################.#####.....................##
#............#.....................#...........###............#########.#########.####.##.....................#.#############......#########
#.............#...................#............###.#####.####.#########.#########.####.##.#################...#.############........########
#..#.#.........#.......#.........#.............###.#####.####................####.####.##...............###...#.###########..........#######
#...#..#.....#..##...#..........#..............###.#####.####.###################.####.####################..##.##########............######
#.....#..........#...#.........#...............###.##########.###################.####......................###.#########..............#####
#......#....#...#.#.#.....#####................###.##############################.#############################.###........................#
#......#...........##....#.....................###..............................................................###........................#
#.....#.............##..#......................###.################################################################........................#
#....#...............###.......................###.################################################################........................#
#..............................................###.........................................................................................#
#..............................................#############################################################################################
#..........................................................................................................................................#
#..........................................................................................................................................#
#...............#.#.#.#.#.#.#.#.#.#.................................#########################.........#....................................#
#.............#..#..#..#..#..#..#..#......................................................####........#....................................#
#...........#..#...#...#...#..#..#...#................................................######..........#....................................#
#...###################################.........................................##########............#....................................#
#............................................................................##########...............#....................................#
#........................................................................#############................#....................................#
#...................................................................#################.................#....................................#
######################################################...##############################################....................................#
#..........................................................................................................................................#
#..........................................................................................................................................#
#..........................................................................................................................................#
#..........................................................................................................................................#
############################################################################################################################################