##############################################################
#............................................................#
#........................................#.#.................#
#........................................#.#.................#
#....######......####....................#.#.................#
#.................#......................#.#.......##.########
#.................#................#.....#.#.................#
#...##......#....#....####...................................#
#...##.......#...............................................#
#............####..................#.........................#
#........##..####..##........................................#
#........##..####..##........................................#
#........##........##........................................#
#............................................................#
#............................................###########..#..#
#...........#...#............................................#
#...........#...#............................................#
#.......#...#...#.................#......#...................#
#.......#....................................................#
#.......#.....#########......................................#
#.....................#..................#...................#
#......######.........#......................................#
#.....................#......................................#
#............................................................#
##############################################################