###########################
#.........................#
#.........................#
#.........................#
#....######......####.....#
#.................#.......#
#.................#.......#
#...##......#....#....#####
#...##.......#............#
#............####.........#
#........##..####..##.....#
#........##..####..##.....#
#........##........##.....#
#.........................#
#.........................#
#...........#...#.........#
#...........#...#.........#
#.......#...#...#.........#
#.......#.................#
#.......#.....#########...#
#.....................#...#
#......######.........#...#
#.....................#...#
#.........................#
###########################